Composition VII
XXXXX     X  X@     X      X  X     
XXXXX     X  X      X      X  X      
XXXXX     X  X      X      X  X      
XXXXX     X  X      X      X          
XXXXX        X      X      X  X 
XXXXXXXXXXXXXXXXXXXXXXXXXXXXXXX 
    X        X      X      XXXX       
    X     X  X             XXXX       
          X         X      XXXX       
XXXXXXXX XXXXXXXX XXXXXX XXXXXXX
    X     XXXX      X      X  X     
    X     XXXX      X               
XXXXXXXXXXXXXXX XXXXXXXXXXXXX XX
             X      X      X  X       
    X        X      X      X          
    X     X  X      X      X  X       
XXXXXXXXX XXXXXXXXXXXXXXXXXXXXX 
    X     X         XXXXXXXX  X       
    X     X  X      XXXXXXXX  X       
    X     X  X      XXXXXXXX  X       
    X     X  X                X       
    X     X  X      XXXXXXXX  XX      
    X     X  X      X      X  XX     
