Composition VI
XXXXXXXXXXXXXXXX              XX        
XXXXXXXXXXXXXXXX              XX        
XXXXXXXXXXXXXXXX              XX        
XXXXXXXXXXXXXXXX              XX        
XXXXXXXXXXXXXXXX              XX        
XXXXXXXXXXXXXXXX              XX        
XXXXXXXXXXXXXXXX     @        XX        
XXXXXXXXXXXXXXXX              XX        
XXXXXXXXXXXXXXXXXXXXXXXXXXXXXXXX
               X                
               X                
               X                
               X                
               X               
               X              
XXXXXXXXXXXXXX XXXXXXXXXXX XXXXX
XXX            XXXXXXXXXXX              
XXX            XXXXXXXXXXX              
XXX            XXXXXXXXXXX              
XXX            XXXXXXXXXXX              
XXX            XXXXXXXXXXX              
XXX            X         X              
XXX            X         X              
