FF
XXXXXXXXXXXXXXXXX XXXXXXXXXXXXXX
X     XX    XXXXX XXXXX        X
X XXX XX XX XXXXX XXXXX XX XXX X
X XXX    XX XXXXX XXXXX XX XXX X
X XXX XXXXX XXXXX XXXXX XX XXX X
X XXX@                         X
X XXXXXX XX XXXXX XXXXXXXX XXX X
X XXXXXX XX XXXXX XXXXXXXX XXX X
X XXX    XX          XX    XXX X
X XXX XX XX XX XXXXX XX XX XXX X
X     XX    XX X   X    XX     X
X XXXXXX XXXXX X     XXXXX XXXXX
X XXXXXX XXXXX X     XXXXX XXXXX
X     XX    XX X   X    XX     X
X XXX XX XX XX XXXXX XX XX XXX X
X XXX    XX          XX    XXX X
X XXXXXX XX XXXXX XXXXXXXX XXX X
X XXX                          X
X XXX XXXXX XXXXX XXXXX XX XXX X
X XXX    XX XXXXX XXXXX XX XXX X
X XXX XX XX XXXXX XXXXX XX XXX X
X     XX    XXXXX XXXXX        X
XXXXXXXXXXXXXXXXX XXXXXXXXXXXXXX
