I'M FREE
XXXXXXXXXXXXXXX  XXXXXXXXXXXXXXX
X                              X
X                              X
X                              X
X                              X
X                              X
X      @                       X
X                              X
X                              X
X                              X
                                
                                
                                
X                              X
X                              X
X                              X
X                              X
X                              X
X                              X
X                              X
X                              X
X                              X
XXXXXXXXXXXXXXX  XXXXXXXXXXXXXXX
