Wall Of Death
XXXXXXXXXXXXXXXXXXXXXXXXXXXXXXXX
X                              X
X                              X
X                              X
X                              X
X                              X
X      @                       X
X                              X
X                              X
X                              X
X                              X
X                              X
X                              X
X                              X
X                              X
X                              X
X                              X
X                              X
X                              X
X                              X
X                              X
X                              X
XXXXXXXXXXXXXXXXXXXXXXXXXXXXXXXX
