Watch out
XX                              
X                               
                                
                                
          X  XXX        X       
XX                             X
@                            XXX
XX         XX               XXXX
 X                   XXX        
XX                   X X       X
                     XXX       X
 X          X                   
 X                            XX
                              X 
                   X          X 
   X              XXX         XX
   X               X            
   X                            
   X    XXXX                    
   X    X  X        XXXX        
   XXXXXXXXX        X  X        
        XXXX        X  X        
        XXXX        XXXX        
